,Rank,Name,G,Rush Yards,Pass Yards,Plays,Total Yards,Yards/Play,Yards/G
0,1,TCU,13,1296,1674,714,2970,4.16,228.5
1,2,Boise State,13,1349,1962,832,3311,3.98,254.7
2,3,West Virginia,13,1124,2270,803,3394,4.23,261.1
3,4,Ohio State,13,1253,2152,789,3405,4.32,261.9
4,5,Alabama,13,1432,2291,802,3723,4.64,286.4
5,6,Texas,12,1663,1939,783,3602,4.60,300.2
6,7,Syracuse,13,1770,2134,856,3904,4.56,300.3
7,8,Pittsburgh,13,1560,2406,837,3966,4.74,305.1
8,9,Florida,13,1698,2287,853,3985,4.67,306.5
9,10,Kent State,12,1166,2514,839,3680,4.39,306.7
10,11,Nebraska,14,2144,2151,940,4295,4.57,306.8
11,12,LSU,13,1785,2208,822,3993,4.86,307.2
12,13,Boston College,13,1074,2950,911,4024,4.42,309.5
13,14,Louisville,13,1876,2176,814,4052,4.98,311.7
14,15,UCF,14,1517,2898,926,4415,4.77,315.4
15,16,Temple,12,1672,2138,816,3810,4.67,317.5
16,17,South Florida,13,1638,2500,873,4138,4.74,318.3
17,18,California,12,1601,2226,797,3827,4.80,318.9
18,19,Clemson,13,1669,2494,865,4163,4.81,320.2
19,20,Wisconsin,13,1662,2521,790,4183,5.29,321.8
20,21,Stanford,13,1571,2626,830,4197,5.06,322.8
21,22,Miami (Florida),13,2246,1957,874,4203,4.81,323.3
22,23,Georgia,13,1927,2344,828,4271,5.16,328.5
23,24,BYU,13,1802,2499,846,4301,5.08,330.8
24,25,Iowa,13,1320,2997,886,4317,4.87,332.1
25,26,Northern Illinois,14,1771,2915,907,4686,5.17,334.7
26,27,Utah,13,1452,2927,831,4379,5.27,336.8
27,28,Miami (Ohio),14,1786,2949,872,4735,5.43,338.2
28,28,Army,13,1809,2588,753,4397,5.84,338.2
29,30,North Carolina,13,1633,2768,871,4401,5.05,338.5
30,31,North Carolina State,13,1486,2926,839,4412,5.26,339.4
31,32,Arizona,13,1712,2713,894,4425,4.95,340.4
32,33,Buffalo,12,1909,2177,828,4086,4.93,340.5
33,34,Oregon,13,1665,2833,963,4498,4.67,346.0
34,35,Penn State,13,2153,2356,834,4509,5.41,346.8
35,36,Arkansas,13,2114,2409,862,4523,5.25,347.9
36,37,Air Force,13,2620,1921,870,4541,5.22,349.3
37,38,Illinois,13,1700,2867,847,4567,5.39,351.3
38,39,Maryland,13,1618,2962,979,4580,4.68,352.3
39,40,SMU,14,2027,2913,980,4940,5.04,352.9
40,41,Ohio,13,1600,2994,866,4594,5.30,353.4
41,42,Florida State,14,1802,3150,1005,4952,4.93,353.7
42,43,Michigan State,13,1738,2861,873,4599,5.27,353.8
43,44,San Diego State,13,1939,2665,948,4604,4.86,354.2
44,44,Kentucky,13,2302,2302,820,4604,5.61,354.2
45,46,South Carolina,14,1574,3387,927,4961,5.35,354.4
46,47,Missouri,13,1988,2645,925,4633,5.01,356.4
47,47,Southern Mississippi,13,1469,3164,835,4633,5.55,356.4
48,49,Mississippi State,13,1548,3091,881,4639,5.27,356.8
49,50,Hawai'i,14,1902,3104,969,5006,5.17,357.6
50,51,Notre Dame,13,1870,2790,904,4660,5.15,358.5
51,52,Virginia Tech,14,2183,2878,894,5061,5.66,361.5
52,53,Oklahoma,14,2085,2981,1000,5066,5.07,361.9
53,54,Nevada,14,1684,3406,916,5090,5.56,363.6
54,55,Texas A&M,13,1692,3044,991,4736,4.78,364.3
55,56,Toledo,13,1735,3007,891,4742,5.32,364.8
56,57,Connecticut,13,1862,2906,923,4768,5.17,366.8
57,58,Arizona State,12,1463,2943,871,4406,5.06,367.2
58,58,Fresno State,13,2060,2714,827,4774,5.77,367.2
59,60,Auburn,14,1527,3630,963,5157,5.36,368.4
60,61,Florida International,13,2198,2598,862,4796,5.56,368.9
61,62,Purdue,12,1655,2773,848,4428,5.22,369.0
62,63,Cincinnati,12,1625,2808,835,4433,5.31,369.4
63,64,Georgia Tech,13,2206,2625,854,4831,5.66,371.6
64,65,Rutgers,12,1877,2613,778,4490,5.77,374.2
65,66,Central Michigan,12,2063,2461,816,4524,5.54,377.0
66,67,Western Kentucky,12,2137,2425,763,4562,5.98,380.2
67,68,Louisiana-Monroe,12,1933,2631,804,4564,5.68,380.3
68,69,Tennessee,13,1983,2985,913,4968,5.44,382.2
69,70,Washington,13,2476,2527,889,5003,5.63,384.8
70,71,Marshall,12,1746,2886,888,4632,5.22,386.0
71,72,Middle Tennessee,13,2442,2587,980,5029,5.13,386.8
72,73,Western Michigan,12,1999,2655,814,4654,5.72,387.8
73,74,Tulane,12,2346,2335,785,4681,5.96,390.1
74,75,Navy,13,2156,2921,894,5077,5.68,390.5
75,76,Minnesota,12,2297,2409,716,4706,6.57,392.2
76,77,North Texas,12,2219,2515,801,4734,5.91,394.5
77,78,Virginia,12,2444,2309,784,4753,6.06,396.1
78,79,Ball State,12,2140,2640,816,4780,5.86,398.3
79,80,UAB,12,1810,2976,831,4786,5.76,398.8
80,81,Mississippi,12,1834,2956,765,4790,6.26,399.2
81,82,Louisiana-Lafayette,12,1952,2842,812,4794,5.90,399.5
82,83,USC,13,1826,3374,880,5200,5.91,400.0
83,83,Colorado,12,1683,3117,809,4800,5.93,400.0
84,85,Florida Atlantic,12,2462,2354,861,4816,5.59,401.3
85,86,Oregon State,12,2154,2738,862,4892,5.68,407.7
86,87,Iowa State,12,2236,2663,884,4899,5.54,408.3
87,88,Oklahoma State,13,1738,3586,1069,5324,4.98,409.5
88,89,Troy,13,2148,3180,914,5328,5.83,409.8
89,90,Indiana,12,2062,2860,751,4922,6.55,410.2
90,91,UTEP,13,2393,2971,935,5364,5.74,412.6
91,92,Wyoming,12,2461,2495,855,4956,5.80,413.0
92,93,Idaho,13,2441,3008,926,5449,5.88,419.2
93,94,Vanderbilt,12,2316,2715,868,5031,5.80,419.3
94,95,UCLA,12,2466,2575,833,5041,6.05,420.1
95,96,Colorado State,12,2383,2711,785,5094,6.49,424.5
96,97,Northwestern,13,2405,3135,933,5540,5.94,426.2
97,98,Kansas,12,2462,2670,832,5132,6.17,427.7
98,99,Akron,12,1969,3169,814,5138,6.31,428.2
99,100,Wake Forest,12,2297,2858,884,5155,5.83,429.6
100,101,Utah State,12,2159,2997,849,5156,6.07,429.7
101,102,Bowling Green,12,2493,2691,847,5184,6.12,432.0
102,103,Houston,12,2505,2689,896,5194,5.80,432.8
103,104,Baylor,13,2214,3446,975,5660,5.81,435.4
104,105,Arkansas State,12,2501,2762,889,5263,5.92,438.6
105,106,Kansas State,13,3008,2786,907,5794,6.39,445.7
106,107,Rice,12,1742,3644,841,5386,6.40,448.8
107,108,Duke,12,2499,2902,848,5401,6.37,450.1
108,109,UNLV,13,2895,2961,879,5856,6.66,450.5
109,110,Michigan,13,2456,3404,963,5860,6.09,450.8
110,110,Tulsa,13,1714,4147,942,5861,6.22,450.8
111,112,New Mexico State,12,2485,2955,798,5440,6.82,453.3
112,113,Eastern Michigan,12,2767,2682,751,5449,7.26,454.1
113,114,Texas Tech,13,2113,3819,1029,5932,5.76,456.3
114,115,Memphis,12,2075,3453,837,5528,6.60,460.7
115,116,Louisiana Tech,12,2063,3482,918,5545,6.04,462.1
116,117,San Jose State,13,2641,3387,940,6028,6.41,463.7
117,118,Washington State,12,2661,2943,832,5604,6.74,467.0
118,119,New Mexico,12,3002,2626,885,5628,6.36,469.0
119,120,East Carolina,13,2947,3277,958,6224,6.50,478.8
